#########################
S.......#.#.............#
#.#######.#.###########.#
#.......#.#.#.........#.#
#######.#.#.#.####.##.#.#
#.....#.#.#.#....#.#..#.#
#.#####.#.#.####.#.#.##.#
#.#................#..#.#
#.#.############.#.##.#.#
#.#.#..........#.#....#.#
#.#.#.########.########.#
#...#.#......#..........#
#####.#####.#########.###
#...............#.......#
#.#################.#####
#.#.#.#.........#.#.....#
#.#...#.#######.#.#.#####
#.#.#.#.#.#...#.#.......#
#.#.#.#.#.#.#.#.#######.#
#.###.#.#.#.#.#.......#.#
#...#.#.#.#.#.##.######.#
#.#...#.....#..#.#......#
#.###########.##.########
#..............#........E
#########################