#########################
........#.#.............#
#.#######.#.###########.#
#.......#.#.#.........#.#
#######.#.#.#.####.##.#.#
#.....#.#.#.#....#.#..#.#
#.#####.#.#.####.#.#.##.#
#.#................#..#.#
#.#.############.#.##.#.#
#.#.#..........#.#....#.#
#.#.#.########.########.#
#...#.#......#..........#
#####.#####.#############
#...............#.......#
#.#####.###########.#####
#.#.#.#.#.......#.#.....#
#.#...#.#.#####.#.#.#####
#.#.#.#.#.#...#.#...#...#
#.#.#.#.#.#.#.#.#######.#
#.###.#.#.#.#.#.......#.#
#...#...#.#.#.##.####.#.#
#.#...#.#...#..#........#
#.###########.##.########
#..............#.........
#########################