#########################
#...........#...........E
#...........#...........#
#...........#...........#
#...........#...........#
#...........#...........#
#..O........#...........#
#...........#...........#
#...........#...........#
#...........#...........#
#...........#...........#
#...........#...........#
#########################
#.........#...........#P#
#.###.##.##.###.#######.#
###....#..#.#...#.......#
#...#.###.#.###.###.###.#
#.######..#.#.#.#.#...#.#
#.#....#.##.#.#.#.#.###.#
#.####.#....#.#.#.#...###
#......####.#.#.#.###.#.#
#.####.#.#..#...#.......#
#.#.##.#.##.#######.#####
S.#......#..............#
#########################