#########################
#...#...#...#...........E
#.#.#.#...#.#.###.#######
#.#...#########.#.#.....#
#.#.###.....#.#.#.#.#.#.#
#.#.#.#.#.#.#.#.....###.#
#.#O#.###.#.#.#######.#.#
#.#.#.#.#.#....#......#.#
#.#.#.#.#.#.##.##.#.#.#.#
#.#.....#.#.#..#..#.#.#.#
#.#######.###.#####.#.#.#
#...........#.......#...#
#########################
#.........#...........#P#
#.###.##.##.###.#######.#
###....#..#.#...#.......#
#...#.###.#.###.###.###.#
#.######..#.#.#.#.#...#.#
#.#....#.##.#.#.#.#.###.#
#.####.#....#.#.#.#...###
#......####.#.#.#.###.#.#
#.####.#.#..#...#.......#
#.#.##.#.##.#######.#####
S.#......#..............#
#########################