#########################
#...........#...........E
#...........#...........#
#...........#...........#
#...........#...........#
#...........#...........#
#...........#...........#
#...........#...........#
#...........#...........#
#...........#...........#
#...........#...........#
#...........#...........#
#########################
#.........#.#...........#
#.###.##.##.#...........#
###....#..#.#...........#
#...#.###.#.#...........#
#.######..#.#...........#
#.#....#.##.#...........#
#.####.#....#...........#
#......####.#...........#
#.####.#.#..#...........#
#.#.##.#.##.#...........#
S.#......#P.#..........O#
#########################